..........................................
..........................................
..........................................
..........................................
..........................................
..........................................
..........................................
..........................................
..P.......................................
..BBBBBBB.................................
..........................................
..........................................
..........................................
BBBBBBBBBBBBBBBBBBBBBBBBBBBBBBBBBBBBBBBBBB