BB........................B
..........................B
..........................B
..........................B
..........................B
..........................B
..........................B
..BBBBBBBBBBBBBBBBBBBB....B
..........................B
..........................B
..........................B
..........................B
P.........................B
..........................B