...........................
...........................
...........................
...........................
...........................
...........................
...........................
...........................
..P........................
..BBBBBBB..................
...........................
...........................
...........................
BBBBBBBBBBBBBBBBBBBBBBBBBBB